##,^^,##
##,AA,##
##,>>,##
##,%U,##
##,(),##
##,##,##

AA-> = "Zeus\n"
