##,##,##
##,^^,## 
##,AA,..## 
##,>>,..## 
##,##,##

AA-> ="Zeus\n"

