##,^^,##
##,AA,##
##,>>,##
##,AB,##
##,>>,##
##,AC,##
##,>>,##
##,AD,##
##,>>,##
##,AE,##
##,>>,##
##,AF,##
##,>>,##
##,AG,##
##,>>,##
##,AH,##
##,>>,##
##,AI,##
##,>>,##
##,AJ,##
##,>>,##
##,(),##

AA -> == "2\n"
AB -> == "3\n"
AC -> == "5\n"
AD -> == "7\n"
AE -> == "11\n"
AF -> == "13\n"
AG -> == "17\n"
AH -> == "19\n"
AI -> == "23\n"
AJ -> == "29\n"
