##,##,##
##,^^,##
##,AA,##
##,>>,##
##,(),##
##,##,##

AA-> ="Zeus is de max!"