##,^^,##
##,<<,##
##,AA,##
##,>>,##
##,(),##
##,##,##

AA-> *= 100
