##,##,##,##,##,##,##
##,##,##,^^,##,##,##
##,##,..,<>,..,##,##
##,##,BC,##,<<,##,##
##,##,..,##,%D,AB,##
##,..,%D,##,AA,**,##
##,BB,BA,##,(),##,##
##,##,>>,##,##,##,##
##,##,(),##,##,##,##

AA -> IF == 0 THEN %D ELSE %R
AB -> -= 1
BA -> IF ** THEN %L ELSE %D
BB -> += 100
BC -> == 0

