##,##,##,^^,##,##,##,##,##
##,..,<<,<>,<<,..,##,##,##
##,..,##,##,##,..,##,##,##
(),ZE,**,##,##,%R,SI,>>,()
##,..,DE,##,##,..,IN,##,##
##,##,##,##,##,##,##,##,##

SI -> IF ** THEN %D ELSE %R
ZE -> IF == 0 THEN %L ELSE %R
IN -> += 1
DE -> -= 1
