##,##,##
##,^^,##
##,AA,##,##,##
##,>>,..,..,##
##,..,##,..,##
##,..,..,..,##
##,##,##,##,##

AA-> ="ZEUS\n"