##,##,##
##,^^,##
##,<<,##
##,BB,##
##,>>,##
##,(),##
##,##,##

BB-> += 1